11111111111111
1000P011000001
110001C0000001
10001C100000E1
10000100000001
10000000000001
10000000000001
10000000000001
10000000000001
10000000000001
10000000000001
11111111111111