1111111111111111111111
1000000000000000010001
10000000000P0000110001
1000000000000000000001
1000000C00000000010C11
10001C1000011000010001
10000100000000000E0001
1111111111111111111111