1111111111111111111111
10000C0000000000010C01
10001110000000P0000111
1000000C00000000000001
1000000100000000010C11
10001C1000011000010001
10000100000000000E0001
1111111111111111111111