1111111111111111111111111111111111
100000000000100C000001000000000001
1010010100101111111001000000010101
101001001010101000C001000000010101
1P0000000C00C00001000E0000000000C1
1111111111111111111111111111111111