1111111111111
10000000000C1
1100011111001
1P00101E00001
1111111111111