1111111
1000E11
1P00011
1111011
1111011
1000011
1111111