1111111111111111111111111111111111
100000000000100C000001E10000000001
1010010100101111110011100000101011
101001001010101000C000000000010101
1P0000000C00C0000100000000000000C1
1111111111111111111111111111111111
