11111111111
10C00010001
10000010C01
100C0000001
1000000E001
10P00010001
11111111111